ZIP_Code,Median_income,Population,TeslaCount,NonTeslaCount,Total_EVs,Tesla_Proportion_of_Evs,EV_per_1k_people
55001,130625,2995,34,84,118,0.288,39.4
55003,115781,4024,15,36,51,0.294,12.67
55005,109464,4927,10,25,35,0.286,7.1
55006,64167,3883,4,9,13,0.308,3.35
55007,66875,2272,0,5,5,0,2.2
55008,83209,16514,31,83,114,0.272,6.9
55009,89023,8252,11,36,47,0.234,5.7
55011,126957,10517,29,50,79,0.367,7.51
55012,93500,1948,6,9,15,0.4,7.7
55013,99898,6985,23,46,69,0.333,9.88
55014,98952,28603,134,193,327,0.41,11.43
55016,121295,38427,237,296,533,0.445,13.87
55017,78333,752,2,1,3,0.667,3.99
55018,91071,968,3,2,5,0.6,5.17
55019,112273,2168,2,17,19,0.105,8.76
55020,127159,4053,24,37,61,0.393,15.05
55021,70296,30636,43,118,161,0.267,5.26
55024,123582,35948,152,255,407,0.373,11.32
55025,95993,25784,99,152,251,0.394,9.73
55026,104688,399,0,3,3,0,7.52
55027,92857,3089,3,6,9,0.333,2.91
55029,75833,119,0,2,2,0,16.81
55030,76875,1323,1,1,2,0.5,1.51
55031,113654,1997,2,9,11,0.182,5.51
55032,106522,3619,5,10,15,0.333,4.14
55033,102026,29701,74,179,253,0.292,8.52
55037,61319,5057,3,12,15,0.2,2.97
55038,127194,23735,172,515,687,0.25,28.94
55040,88576,13941,18,54,72,0.25,5.16
55041,83673,7800,15,29,44,0.341,5.64
55042,154779,12044,210,268,478,0.439,39.69
55043,101754,3459,16,39,55,0.291,15.9
55044,140612,60446,690,847,1537,0.449,25.43
55045,110685,7804,23,51,74,0.311,9.48
55046,91982,6093,20,29,49,0.408,8.04
55047,100357,2491,34,73,107,0.318,42.95
55049,90700,2619,3,5,8,0.375,3.05
55051,71232,9858,5,18,23,0.217,2.33
55052,78375,1995,4,8,12,0.333,6.02
55053,107188,1079,3,6,9,0.333,8.34
55054,151845,2489,11,11,22,0.5,8.84
55055,63365,3797,24,41,65,0.369,17.12
55056,93601,14245,28,59,87,0.322,6.11
55057,97521,25519,79,298,377,0.21,14.77
55060,83848,29693,47,113,160,0.294,5.39
55063,74854,9236,9,42,51,0.176,5.52
55065,116500,1217,49,80,129,0.38,106
55066,70529,18732,24,134,158,0.152,8.43
55068,125271,31593,267,316,583,0.458,18.45
55069,75139,5630,10,9,19,0.526,3.37
55070,101925,8342,16,36,52,0.308,6.23
55071,98945,5827,13,15,28,0.464,4.81
55072,57500,4346,1,8,9,0.111,2.07
55073,130556,3532,17,36,53,0.321,15.01
55074,104545,2415,4,22,26,0.154,10.77
55075,84573,20749,38,88,126,0.302,6.07
55076,98026,21624,55,128,183,0.301,8.46
55077,108314,14258,144,212,356,0.404,24.97
55079,111484,8875,12,35,47,0.255,5.3
55080,100789,2768,6,12,18,0.333,6.5
55082,117538,36441,285,600,885,0.322,24.29
55084,90500,1777,2,11,13,0.154,7.32
55085,93333,412,0,1,1,0,2.43
55087,126364,326,0,2,2,0,6.13
55088,128958,1889,4,13,17,0.235,9
55089,105938,1849,6,22,28,0.214,15.14
55090,80179,450,3,2,5,0.6,11.11
55092,97241,10801,34,52,86,0.395,7.96
55101,72703,7788,35,103,138,0.254,17.72
55102,74143,20355,77,391,468,0.165,22.99
55103,47872,13874,18,72,90,0.2,6.49
55104,75038,45612,141,553,694,0.203,15.22
55105,108200,28812,198,656,854,0.232,29.64
55106,68601,60327,106,213,319,0.332,5.29
55107,78125,15383,36,111,147,0.245,9.56
55108,84583,14767,63,285,348,0.181,23.57
55109,81759,35381,128,216,344,0.372,9.72
55110,97211,39205,159,436,595,0.267,15.18
55111,-,92,2,36,38,0.053,413.04
55112,93823,46728,283,911,1194,0.237,25.55
55113,86830,41699,208,516,724,0.287,17.36
55114,65236,5012,33,53,86,0.384,17.16
55115,132796,8880,87,151,238,0.366,26.8
55116,83156,25992,265,666,931,0.285,35.82
55117,71784,44525,191,484,675,0.283,15.16
55118,85229,29106,145,378,523,0.277,17.97
55119,77870,43010,92,206,298,0.309,6.93
55120,111900,4752,34,84,118,0.288,24.83
55121,86929,9468,59,545,604,0.098,63.79
55122,93980,32204,211,350,561,0.376,17.42
55123,134265,27153,232,393,625,0.371,23.02
55124,99354,56353,342,531,873,0.392,15.49
55125,118129,43846,306,464,770,0.397,17.56
55126,109017,27390,205,357,562,0.365,20.52
55127,113355,18071,220,317,537,0.41,29.72
55128,89642,29217,126,172,298,0.423,10.2
55129,152500,31236,637,540,1177,0.541,37.68
55130,53281,18581,16,29,45,0.356,2.42
55144,,,0,1,1,0,NULL
55150,108750,173,0,4,4,0,23.12
55155,-,12,0,21,21,0,1750
55301,131157,12791,62,84,146,0.425,11.41
55302,78194,7274,12,42,54,0.222,7.42
55303,101351,51480,152,273,425,0.358,8.26
55304,127145,49128,346,770,1116,0.31,22.72
55305,106480,21533,251,360,611,0.411,28.38
55306,98012,16984,80,148,228,0.351,13.42
55307,72059,3126,3,4,7,0.429,2.24
55308,103815,9691,28,33,61,0.459,6.29
55309,118387,20387,68,81,149,0.456,7.31
55310,81667,1449,0,6,6,0,4.14
55311,148122,37390,502,487,989,0.508,26.45
55312,97976,1527,1,7,8,0.125,5.24
55313,93471,24406,63,108,171,0.368,7.01
55315,140446,6353,78,78,156,0.5,24.56
55316,115719,23919,113,164,277,0.408,11.58
55317,133573,21774,286,389,675,0.424,31
55318,111781,29729,234,376,610,0.384,20.52
55319,111343,5415,12,18,30,0.4,5.54
55320,109242,5072,13,26,39,0.333,7.69
55321,81250,5597,5,16,21,0.238,3.75
55322,112455,3637,4,26,30,0.133,8.25
55324,81488,1228,1,4,5,0.2,4.07
55325,89122,4792,3,13,16,0.188,3.34
55327,133721,4935,59,67,126,0.468,25.53
55328,118036,9729,42,78,120,0.35,12.33
55329,74063,2035,4,3,7,0.571,3.44
55330,111481,43626,206,254,460,0.448,10.54
55331,160029,19568,372,530,902,0.412,46.1
55332,58177,1838,1,4,5,0.2,2.72
55333,62250,776,0,2,2,0,2.58
55334,70150,2885,2,7,9,0.222,3.12
55335,59034,1625,1,9,10,0.1,6.15
55336,73314,8145,11,17,28,0.393,3.44
55337,81641,47333,192,340,532,0.361,11.24
55338,85347,1128,2,5,7,0.286,6.21
55339,88929,1004,1,2,3,0.333,2.99
55340,174120,8988,233,279,512,0.455,56.96
55341,147903,3484,23,25,48,0.479,13.78
55342,63257,1788,0,1,1,0,0.56
55343,82415,26307,164,313,477,0.344,18.13
55344,89590,15837,156,181,337,0.463,21.28
55345,143287,22051,239,412,651,0.367,29.52
55346,137125,17139,167,267,434,0.385,25.32
55347,152850,31222,554,598,1152,0.481,36.9
55349,100054,3945,8,10,18,0.444,4.56
55350,78663,18669,31,80,111,0.279,5.95
55352,112923,10020,48,89,137,0.35,13.67
55353,87969,3247,4,16,20,0.2,6.16
55354,94950,2868,4,9,13,0.308,4.53
55355,70878,9592,11,20,31,0.355,3.23
55356,171333,5790,80,148,228,0.351,39.38
55357,147256,3370,12,38,50,0.24,14.84
55358,94911,5361,10,18,28,0.357,5.22
55359,129508,6375,62,86,148,0.419,23.22
55360,118036,3387,12,21,33,0.364,9.74
55362,92870,20476,76,94,170,0.447,8.3
55363,98287,5290,13,13,26,0.5,4.91
55364,111083,15210,150,215,365,0.411,24
55367,89896,992,2,1,3,0.667,3.02
55368,76719,2305,4,9,13,0.308,5.64
55369,112541,38379,340,453,793,0.429,20.66
55370,117344,762,2,3,5,0.4,6.56
55371,89674,17132,25,49,74,0.338,4.32
55372,140835,34327,340,436,776,0.438,22.61
55373,95273,5728,23,42,65,0.354,11.35
55374,152239,15851,157,173,330,0.476,20.82
55375,136250,4778,23,28,51,0.451,10.67
55376,130917,17989,122,150,272,0.449,15.12
55378,122237,31906,246,303,549,0.448,17.21
55379,109824,48254,342,407,749,0.457,15.52
55381,87011,2020,1,2,3,0.333,1.49
55382,95673,3787,4,22,26,0.154,6.87
55384,46860,1734,9,13,22,0.409,12.69
55385,75365,1169,0,5,5,0,4.28
55386,191279,9396,124,154,278,0.446,29.59
55387,109279,14552,76,144,220,0.345,15.12
55388,92273,5984,18,33,51,0.353,8.52
55389,92109,2615,4,2,6,0.667,2.29
55390,107500,3186,3,16,19,0.158,5.96
55391,170115,15782,323,523,846,0.382,53.61
55395,72901,2849,2,5,7,0.286,2.46
55396,72232,2093,0,6,6,0,2.87
55397,77227,2871,9,9,18,0.5,6.27
55398,105063,17022,46,61,107,0.43,6.29
55401,115651,12029,157,228,385,0.408,32.01
55402,69808,682,7,15,22,0.318,32.26
55403,59928,17707,108,502,610,0.177,34.45
55404,43932,29322,59,95,154,0.383,5.25
55405,70425,15497,128,368,496,0.258,32.01
55406,91865,34588,150,763,913,0.164,26.4
55407,78206,38506,105,414,519,0.202,13.48
55408,72421,33718,132,319,451,0.293,13.38
55409,98056,11843,53,236,289,0.183,24.4
55410,144973,21352,320,811,1131,0.283,52.97
55411,53368,31214,61,126,187,0.326,5.99
55412,71905,23800,46,137,183,0.251,7.69
55413,84252,13914,72,164,236,0.305,16.96
55414,47004,36600,102,288,390,0.262,10.66
55415,126480,5435,105,156,261,0.402,48.02
55416,105926,34129,368,783,1151,0.32,33.72
55417,122639,26259,126,527,653,0.193,24.87
55418,95630,31887,163,423,586,0.278,18.38
55419,143254,27919,268,797,1065,0.252,38.15
55420,77539,23128,68,156,224,0.304,9.69
55421,75141,30580,94,177,271,0.347,8.86
55422,91173,29290,207,418,625,0.331,21.34
55423,84102,37137,143,274,417,0.343,11.23
55424,241875,10175,232,454,686,0.338,67.42
55425,68517,10281,49,80,129,0.38,12.55
55426,96887,26716,158,368,526,0.3,19.69
55427,92013,24353,132,275,407,0.324,16.71
55428,69004,31896,80,147,227,0.352,7.12
55429,66661,28755,54,95,149,0.362,5.18
55430,77385,24058,44,99,143,0.308,5.94
55431,103125,19767,77,219,296,0.26,14.97
55432,77985,33022,111,170,281,0.395,8.51
55433,80213,34618,82,188,270,0.304,7.8
55434,88163,31776,233,295,528,0.441,16.62
55435,75829,14170,145,199,344,0.422,24.28
55436,132487,14395,254,366,620,0.41,43.07
55437,98120,19686,101,241,342,0.295,17.37
55438,103488,17079,137,202,339,0.404,19.85
55439,173925,9309,230,279,509,0.452,54.68
55441,100288,18415,158,262,420,0.376,22.81
55442,121714,12866,100,181,281,0.356,21.84
55443,88220,36771,210,248,458,0.459,12.46
55444,114545,17214,45,76,121,0.372,7.03
55445,103227,13865,79,102,181,0.436,13.05
55446,169412,28725,678,567,1245,0.545,43.34
55447,128781,21357,201,311,512,0.393,23.97
55448,95610,28970,88,140,228,0.386,7.87
55449,128750,33321,381,390,771,0.494,23.14
55450,-,27,0,171,171,0,6333.33
55454,26429,8279,12,16,28,0.429,3.38
55458,,,1,0,1,1,NULL
55487,,,1,0,1,1,NULL
55602,56667,223,1,1,2,0.5,8.97
55603,62813,510,0,3,3,0,5.88
55604,71458,3661,5,26,31,0.161,8.47
55605,52750,579,0,1,1,0,1.73
55606,72917,295,1,0,1,1,3.39
55607,67500,137,1,0,1,1,7.3
55609,76538,269,0,6,6,0,22.3
55612,83893,604,2,4,6,0.333,9.93
55613,74688,179,1,2,3,0.333,16.76
55614,74313,2476,2,7,9,0.222,3.63
55615,60893,282,2,2,4,0.5,14.18
55616,77242,7024,5,40,45,0.111,6.41
55702,75625,410,1,0,1,1,2.44
55703,69973,744,0,3,3,0,4.03
55704,61875,1072,0,3,3,0,2.8
55705,54047,3226,2,7,9,0.222,2.79
55706,60096,1738,1,7,8,0.125,4.6
55707,81471,3386,2,11,13,0.154,3.84
55708,68859,917,1,1,2,0.5,2.18
55709,71163,4199,1,9,10,0.1,2.38
55710,76694,1327,0,3,3,0,2.26
55711,54583,707,0,2,2,0,2.83
55712,49091,512,0,1,1,0,1.95
55713,58424,979,1,2,3,0.333,3.06
55717,93250,295,1,0,1,1,3.39
55718,98448,3245,7,12,19,0.368,5.86
55719,63497,5668,5,13,18,0.278,3.18
55720,66399,17236,10,40,50,0.2,2.9
55721,82750,3667,1,13,14,0.071,3.82
55722,57436,1169,0,4,4,0,3.42
55723,63958,2222,1,12,13,0.077,5.85
55724,73500,824,1,1,2,0.5,2.43
55726,76667,999,1,1,2,0.5,2
55731,62900,5494,13,24,37,0.351,6.73
55732,62604,1358,0,3,3,0,2.21
55733,115051,5104,6,16,22,0.273,4.31
55734,65750,5964,5,16,21,0.238,3.52
55735,62125,1699,0,3,3,0,1.77
55736,65000,1454,0,1,1,0,0.69
55738,80278,483,0,4,4,0,8.28
55741,66528,3110,4,8,12,0.333,3.86
55744,68213,20096,16,54,70,0.229,3.48
55746,55694,17071,6,27,33,0.182,1.93
55748,54615,1394,0,3,3,0,2.15
55749,82530,452,0,1,1,0,2.21
55750,64653,2035,1,4,5,0.2,2.46
55751,72969,1474,0,4,4,0,2.71
55752,77083,401,1,0,1,1,2.49
55753,50407,970,0,1,1,0,1.03
55758,53750,156,0,1,1,0,6.41
55760,60341,2890,0,8,8,0,2.77
55763,71923,570,0,2,2,0,3.51
55765,73750,780,0,1,1,0,1.28
55767,73810,4495,1,18,19,0.053,4.23
55768,82261,2878,1,13,14,0.071,4.86
55769,66149,2235,2,2,4,0.5,1.79
55771,65893,1485,1,2,3,0.333,2.02
55775,81250,1242,3,2,5,0.6,4.03
55779,98958,3974,5,10,15,0.333,3.77
55781,95536,728,2,7,9,0.222,12.36
55783,79052,2484,2,9,11,0.182,4.43
55787,63750,454,2,2,4,0.5,8.81
55790,74732,1876,1,4,5,0.2,2.67
55792,50616,9827,0,24,24,0,2.44
55793,66458,606,0,3,3,0,4.95
55795,69485,1624,1,4,5,0.2,3.08
55796,56429,195,0,1,1,0,5.13
55797,88203,1525,0,6,6,0,3.93
55798,78929,664,1,0,1,1,1.51
55802,40850,2544,11,30,41,0.268,16.12
55803,104250,17796,44,122,166,0.265,9.33
55804,108231,15471,59,129,188,0.314,12.15
55805,43077,9731,8,30,38,0.211,3.91
55806,44962,9761,7,39,46,0.152,4.71
55807,63670,9674,8,29,37,0.216,3.82
55808,59808,5943,4,17,21,0.19,3.53
55810,81894,8700,11,31,42,0.262,4.83
55811,77877,27761,46,130,176,0.261,6.34
55812,66961,10571,8,69,77,0.104,7.28
55816,,,0,3,3,0,NULL
55901,90430,58046,200,378,578,0.346,9.96
55902,111879,25878,262,458,720,0.364,27.82
55904,76434,29813,81,159,240,0.338,8.05
55905,-,0,0,3,3,0,NULL
55906,104146,19559,105,226,331,0.317,16.92
55909,93750,1325,1,2,3,0.333,2.26
55912,68205,29718,35,102,137,0.255,4.61
55917,76310,3609,3,8,11,0.273,3.05
55918,79125,955,1,3,4,0.25,4.19
55919,70962,1003,4,4,8,0.5,7.98
55920,126102,8512,43,68,111,0.387,13.04
55921,76679,4808,3,11,14,0.214,2.91
55922,60000,773,0,3,3,0,3.88
55923,93446,4705,4,10,14,0.286,2.98
55924,78194,1217,1,3,4,0.25,3.29
55925,91389,1040,0,6,6,0,5.77
55926,97500,739,1,5,6,0.167,8.12
55927,91536,4154,1,8,9,0.111,2.17
55929,115865,1247,0,5,5,0,4.01
55932,102727,1934,6,10,16,0.375,8.27
55933,61250,247,0,1,1,0,4.05
55934,87645,3332,2,14,16,0.125,4.8
55935,78864,872,0,2,2,0,2.29
55936,79196,1900,0,7,7,0,3.68
55939,66087,2155,0,2,2,0,0.93
55940,83906,2720,6,13,19,0.316,6.99
55941,71607,1021,0,7,7,0,6.86
55943,69896,3037,2,5,7,0.286,2.3
55944,90673,7937,24,26,50,0.48,6.3
55945,77143,1415,4,2,6,0.667,4.24
55946,80461,3288,3,11,14,0.214,4.26
55947,85464,7461,24,44,68,0.353,9.11
55949,80357,1864,4,9,13,0.308,6.97
55951,57692,1535,1,2,3,0.333,1.95
55952,96964,2354,1,8,9,0.111,3.82
55953,66705,888,0,1,1,0,1.13
55954,69615,1480,1,1,2,0.5,1.35
55955,129079,2718,4,17,21,0.19,7.73
55956,94762,1962,3,5,8,0.375,4.08
55957,80000,683,0,2,2,0,2.93
55959,68224,2230,3,3,6,0.5,2.69
55960,122120,3805,20,38,58,0.345,15.24
55961,77083,378,0,1,1,0,2.65
55962,73500,751,0,5,5,0,6.66
55963,109464,5667,9,37,46,0.196,8.12
55964,72765,4520,1,6,7,0.143,1.55
55965,62917,2345,1,5,6,0.167,2.56
55967,107500,941,2,0,2,1,2.13
55968,54688,124,0,1,1,0,8.06
55969,87212,1185,2,1,3,0.667,2.53
55970,85694,933,1,0,1,1,1.07
55971,81146,3112,1,9,10,0.1,3.21
55972,97500,5265,2,16,18,0.111,3.42
55973,88750,282,0,1,1,0,3.55
55974,60700,2058,1,10,11,0.091,5.34
55975,83232,4368,1,12,13,0.077,2.98
55976,79044,8338,10,30,40,0.25,4.8
55979,83482,1067,2,0,2,1,1.87
55981,69195,3998,9,16,25,0.36,6.25
55983,85625,1535,1,9,10,0.1,6.51
55985,84853,1807,5,2,7,0.714,3.87
55987,62171,34010,35,148,183,0.191,5.38
55990,78958,931,0,5,5,0,5.37
55991,86875,1292,1,4,5,0.2,3.87
55992,103144,5161,11,30,41,0.268,7.94
56001,67224,50729,97,237,334,0.29,6.58
56002,,,0,1,1,0,NULL
56003,80587,15221,44,79,123,0.358,8.08
56007,66479,21434,16,47,63,0.254,2.94
56009,82632,1514,1,5,6,0.167,3.96
56010,83854,1046,0,5,5,0,4.78
56011,99628,9538,14,33,47,0.298,4.93
56013,64360,4298,9,12,21,0.429,4.89
56014,60250,755,0,1,1,0,1.32
56016,85938,1020,3,3,6,0.5,5.88
56017,94250,1712,8,4,12,0.667,7.01
56019,68750,867,0,2,2,0,2.31
56021,101250,1115,0,2,2,0,1.79
56024,96667,3580,0,15,15,0,4.19
56025,81000,523,1,1,2,0.5,3.82
56026,96815,1899,1,3,4,0.25,2.11
56027,48214,786,0,1,1,0,1.27
56028,103542,1271,3,6,9,0.333,7.08
56029,61094,664,0,3,3,0,4.52
56031,61373,12117,16,15,31,0.516,2.56
56033,82188,336,1,4,5,0.2,14.88
56034,83068,609,0,2,2,0,3.28
56035,63750,515,0,1,1,0,1.94
56036,70862,1774,0,7,7,0,3.95
56037,74167,1589,0,5,5,0,3.15
56039,80536,990,0,1,1,0,1.01
56041,79107,1075,0,1,1,0,0.93
56042,80500,669,1,1,2,0.5,2.99
56043,93333,449,0,1,1,0,2.23
56044,92917,2135,4,6,10,0.4,4.68
56048,82813,4150,3,15,18,0.167,4.34
56050,85000,1531,3,5,8,0.375,5.23
56051,50909,640,1,5,6,0.167,9.38
56052,89688,746,1,5,6,0.167,8.04
56054,97344,888,0,5,5,0,5.63
56055,83452,3916,7,17,24,0.292,6.13
56057,81895,3949,1,16,17,0.059,4.3
56058,82500,6066,9,18,27,0.333,4.45
56062,76549,3239,2,3,5,0.4,1.54
56063,100156,2945,9,27,36,0.25,12.22
56065,91587,2698,0,4,4,0,1.48
56068,68988,1031,0,2,2,0,1.94
56069,81919,4837,8,20,28,0.286,5.79
56071,109672,12913,24,83,107,0.224,8.29
56072,77917,2401,0,4,4,0,1.67
56073,69698,17275,10,59,69,0.145,3.99
56074,91397,1965,3,5,8,0.375,4.07
56080,100750,727,0,2,2,0,2.75
56081,66612,6139,3,15,18,0.167,2.93
56082,72332,14507,17,72,89,0.191,6.13
56083,65000,797,1,0,1,1,1.25
56085,70429,5087,3,14,17,0.176,3.34
56087,64566,3026,2,2,4,0.5,1.32
56088,70568,1881,0,1,1,0,0.53
56091,57500,343,1,0,1,1,2.92
56093,73210,12469,8,39,47,0.17,3.77
56096,79879,2909,2,12,14,0.143,4.81
56097,63646,3613,5,13,18,0.278,4.98
56098,69000,2073,3,5,8,0.375,3.86
56101,71354,6008,1,11,12,0.083,2
56110,77625,1803,2,4,6,0.333,3.33
56111,91563,399,1,1,2,0.5,5.01
56116,85000,592,0,3,3,0,5.07
56117,80547,348,0,1,1,0,2.87
56118,89076,416,0,2,2,0,4.81
56119,80766,1001,1,1,2,0.5,2
56120,72708,1088,0,2,2,0,1.84
56128,71806,2076,0,6,6,0,2.89
56134,56250,411,0,2,2,0,4.87
56136,59271,1222,0,3,3,0,2.45
56137,68500,1051,1,0,1,1,0.95
56138,68889,919,1,0,1,1,1.09
56139,75417,408,0,1,1,0,2.45
56142,65987,950,0,1,1,0,1.05
56143,64865,4545,5,10,15,0.333,3.3
56144,53077,1223,0,1,1,0,0.82
56145,51607,562,0,1,1,0,1.78
56147,42188,187,0,1,1,0,5.35
56149,61389,1261,0,2,2,0,1.59
56150,69224,2715,0,1,1,0,0.37
56151,78571,745,0,2,2,0,2.68
56152,73542,1402,0,2,2,0,1.43
56153,57813,213,0,1,1,0,4.69
56155,59375,397,0,1,1,0,2.52
56156,75234,6270,3,17,20,0.15,3.19
56157,87708,729,1,0,1,1,1.37
56159,65089,2777,6,7,13,0.462,4.68
56162,83125,221,0,1,1,0,4.52
56164,71550,5678,3,9,12,0.25,2.11
56165,100179,328,0,2,2,0,6.1
56167,68611,619,1,1,2,0.5,3.23
56168,65417,876,0,1,1,0,1.14
56170,54821,549,0,1,1,0,1.82
56171,74750,1676,2,2,4,0.5,2.39
56172,79583,2954,2,8,10,0.2,3.39
56173,57083,368,0,1,1,0,2.72
56174,81563,391,0,2,2,0,5.12
56175,66506,2915,0,2,2,0,0.69
56176,67727,1092,0,3,3,0,2.75
56178,81667,1651,1,5,6,0.167,3.63
56181,59821,1144,0,3,3,0,2.62
56183,49779,1197,0,1,1,0,0.84
56185,59792,551,0,2,2,0,3.63
56187,63637,15312,5,20,25,0.2,1.63
56201,68054,24575,33,76,109,0.303,4.44
56208,56196,2029,2,1,3,0.667,1.48
56209,83661,2333,0,9,9,0,3.86
56211,80536,505,0,1,1,0,1.98
56215,58198,4765,0,10,10,0,2.1
56216,73088,628,1,1,2,0.5,3.18
56220,60185,2851,0,2,2,0,0.7
56221,56875,752,0,1,1,0,1.33
56222,61389,2099,0,3,3,0,1.43
56223,65250,1328,1,5,6,0.167,4.52
56225,68750,805,0,2,2,0,2.48
56227,96250,178,2,1,3,0.667,16.85
56229,99821,1754,0,4,4,0,2.28
56230,65000,794,1,2,3,0.333,3.78
56232,77132,2328,1,3,4,0.25,1.72
56235,80521,505,0,1,1,0,1.98
56236,77344,299,1,0,1,1,3.34
56240,66250,954,0,3,3,0,3.14
56241,66354,3903,2,2,4,0.5,1.02
56243,65625,1690,2,1,3,0.667,1.78
56244,82841,1737,1,2,3,0.333,1.73
56245,82679,455,0,2,2,0,4.4
56251,75938,1063,1,5,6,0.167,5.64
56252,80508,1313,0,7,7,0,5.33
56253,73984,932,0,1,1,0,1.07
56255,70500,414,0,3,3,0,7.25
56256,62250,2433,0,3,3,0,1.23
56258,70640,15480,10,39,49,0.204,3.17
56260,72813,868,1,2,3,0.333,3.46
56264,75227,2113,0,1,1,0,0.47
56265,72564,7634,5,10,15,0.333,1.96
56266,70000,1510,0,2,2,0,1.32
56267,70000,6647,5,27,32,0.156,4.81
56270,64286,1197,1,6,7,0.143,5.85
56271,70395,1292,1,5,6,0.167,4.64
56273,91520,4969,10,16,26,0.385,5.23
56276,68125,241,0,1,1,0,4.15
56277,69265,2950,4,6,10,0.4,3.39
56278,60192,2733,0,3,3,0,1.1
56279,78750,1233,1,1,2,0.5,1.62
56280,74167,441,0,2,2,0,4.54
56281,105121,649,1,0,1,1,1.54
56282,71103,1597,0,3,3,0,1.88
56283,66548,6412,0,15,15,0,2.34
56284,75417,2054,0,1,1,0,0.49
56288,105000,4623,14,32,46,0.304,9.95
56291,58750,452,1,0,1,1,2.21
56292,80156,542,0,1,1,0,1.85
56293,67788,1257,0,3,3,0,2.39
56297,80250,808,0,1,1,0,1.24
56301,69725,33786,48,158,206,0.233,6.1
56302,,,1,2,3,0.333,NULL
56303,66789,27305,42,113,155,0.271,5.68
56304,54133,17020,27,48,75,0.36,4.41
56307,89563,5399,1,11,12,0.083,2.22
56308,76831,26391,41,108,149,0.275,5.65
56309,83594,1326,1,2,3,0.333,2.26
56310,103993,5225,34,88,122,0.279,23.35
56311,70938,695,1,2,3,0.333,4.32
56312,69519,2293,3,4,7,0.429,3.05
56314,87500,1281,3,0,3,1,2.34
56315,85526,1726,1,7,8,0.125,4.63
56316,71071,1438,0,5,5,0,3.48
56318,77875,1158,1,3,4,0.25,3.45
56319,85500,1300,2,4,6,0.333,4.62
56320,90346,7985,16,33,49,0.327,6.14
56324,79219,1000,1,4,5,0.2,5
56326,81765,1577,0,1,1,0,0.63
56327,79643,784,1,8,9,0.111,11.48
56329,89728,7615,8,17,25,0.32,3.28
56330,80250,1763,3,2,5,0.6,2.84
56331,90893,1949,2,5,7,0.286,3.59
56332,89875,1523,0,6,6,0,3.94
56334,67264,5830,9,42,51,0.176,8.75
56336,80804,1483,2,3,5,0.4,3.37
56338,68906,1764,1,9,10,0.1,5.67
56339,57143,1136,0,2,2,0,1.76
56340,89211,2394,1,4,5,0.2,2.09
56342,61313,2791,1,7,8,0.125,2.87
56343,64318,910,0,2,2,0,2.2
56345,57399,15058,11,40,51,0.216,3.39
56347,65650,7449,4,11,15,0.267,2.01
56349,91250,779,1,3,4,0.25,5.13
56350,40000,486,1,1,2,0.5,4.12
56352,71356,5775,2,18,20,0.1,3.46
56353,77170,9314,8,17,25,0.32,2.68
56354,85521,1455,2,3,5,0.4,3.44
56355,97500,641,0,2,2,0,3.12
56357,107031,1053,1,3,4,0.25,3.8
56358,78125,3090,0,12,12,0,3.88
56359,57852,3585,3,2,5,0.6,1.39
56360,65395,4093,2,6,8,0.25,1.95
56361,69896,2425,4,3,7,0.571,2.89
56362,81536,5825,4,18,22,0.182,3.78
56364,77440,5562,1,4,5,0.2,0.9
56367,102429,7164,11,28,39,0.282,5.44
56368,92963,4372,9,13,22,0.409,5.03
56369,84464,545,0,4,4,0,7.34
56371,44250,125,0,2,2,0,16
56373,91544,3233,2,4,6,0.333,1.86
56374,78415,9943,9,31,40,0.225,4.02
56375,94875,800,2,0,2,1,2.5
56377,82583,21013,80,127,207,0.386,9.85
56378,71953,8174,5,19,24,0.208,2.94
56379,71964,17467,23,65,88,0.261,5.04
56381,78348,2511,0,11,11,0,4.38
56385,69375,918,1,4,5,0.2,5.45
56386,52344,654,0,1,1,0,1.53
56387,57387,7715,4,14,18,0.222,2.33
56401,70269,30632,38,90,128,0.297,4.18
56425,71294,8584,20,38,58,0.345,6.76
56431,64846,8763,4,13,17,0.235,1.94
56433,57792,1800,0,3,3,0,1.67
56435,63542,2595,3,7,10,0.3,3.85
56437,59313,1474,0,1,1,0,0.68
56438,57093,2877,0,4,4,0,1.39
56440,53250,1343,1,2,3,0.333,2.23
56441,50705,3439,6,8,14,0.429,4.07
56442,85179,2720,4,20,24,0.167,8.82
56443,73056,1395,1,4,5,0.2,3.58
56444,74265,3044,5,12,17,0.294,5.58
56447,66875,1008,3,2,5,0.6,4.96
56448,77917,441,1,3,4,0.25,9.07
56449,77813,1897,6,3,9,0.667,4.74
56450,59076,1129,1,4,5,0.2,4.43
56452,60378,1919,2,11,13,0.154,6.77
56455,65962,1692,1,7,8,0.125,4.73
56459,,,0,1,1,0,NULL
56461,77692,3416,1,6,7,0.143,2.05
56464,70505,4864,4,4,8,0.5,1.64
56465,70417,2221,4,10,14,0.286,6.3
56466,59046,3157,2,10,12,0.167,3.8
56467,75170,2609,0,3,3,0,1.15
56468,103698,4525,15,24,39,0.385,8.62
56469,60109,1055,0,2,2,0,1.9
56470,68351,10668,12,39,51,0.235,4.78
56472,81938,8315,14,28,42,0.333,5.05
56473,79236,3763,2,9,11,0.182,2.92
56474,55741,4419,1,11,12,0.083,2.72
56475,60481,1611,1,4,5,0.2,3.1
56477,54028,2771,1,3,4,0.25,1.44
56479,58009,5387,2,8,10,0.2,1.86
56481,69688,1972,2,1,3,0.667,1.52
56482,56356,6925,3,10,13,0.231,1.88
56484,64688,3517,2,14,16,0.125,4.55
56501,68980,17784,17,58,75,0.227,4.22
56510,73125,2327,1,1,2,0.5,0.86
56511,87375,2192,1,4,5,0.2,2.28
56514,88690,3963,10,8,18,0.556,4.54
56515,73350,2967,3,10,13,0.231,4.38
56516,62000,255,1,0,1,1,3.92
56520,61537,3952,3,2,5,0.6,1.27
56521,71741,763,0,4,4,0,5.24
56522,81250,515,1,0,1,1,1.94
56523,54400,475,0,1,1,0,2.11
56524,74688,681,1,1,2,0.5,2.94
56528,80667,1669,1,2,3,0.333,1.8
56529,89577,4613,2,12,14,0.143,3.03
56531,73162,2065,1,8,9,0.111,4.36
56534,71932,1189,2,3,5,0.4,4.21
56536,79375,474,4,0,4,1,8.44
56537,62279,19230,27,72,99,0.273,5.15
56540,77500,1919,0,3,3,0,1.56
56542,57750,2718,0,1,1,0,0.37
56543,64643,277,0,1,1,0,3.61
56544,72742,5361,3,3,6,0.5,1.12
56547,95750,2597,0,5,5,0,1.93
56548,67679,737,0,1,1,0,1.36
56549,100326,5075,3,11,14,0.214,2.76
56550,62500,396,0,3,3,0,7.58
56551,63750,2256,1,2,3,0.333,1.33
56553,64971,252,0,1,1,0,3.97
56554,91379,3098,2,7,9,0.222,2.91
56557,53077,2826,1,4,5,0.2,1.77
56560,71114,44205,31,133,164,0.189,3.71
56562,-,461,0,2,2,0,4.34
56563,-,1130,0,2,2,0,1.77
56566,38056,607,0,1,1,0,1.65
56567,69919,3511,3,5,8,0.375,2.28
56569,56250,1279,1,1,2,0.5,1.56
56570,65938,1177,1,1,2,0.5,1.7
56571,83500,1968,2,4,6,0.333,3.05
56572,83631,5747,5,19,24,0.208,4.18
56573,68080,7066,10,19,29,0.345,4.1
56575,55673,773,1,0,1,1,1.29
56576,73523,818,1,0,1,1,1.22
56578,93750,801,1,7,8,0.125,9.99
56580,101477,1249,0,4,4,0,3.2
56584,70398,1348,1,1,2,0.5,1.48
56586,82333,1963,0,4,4,0,2.04
56587,83203,1454,1,7,8,0.125,5.5
56588,66250,522,2,2,4,0.5,7.66
56589,67431,1850,0,3,3,0,1.62
56590,70000,403,0,1,1,0,2.48
56594,93958,406,0,2,2,0,4.93
56601,69782,34647,27,97,124,0.218,3.58
56619,,,0,1,1,0,NULL
56621,63750,4407,1,4,5,0.2,1.13
56623,74000,2640,1,5,6,0.167,2.27
56628,58631,1725,2,2,4,0.5,2.32
56630,51875,2370,2,3,5,0.4,2.11
56633,62422,4751,1,5,6,0.167,1.26
56636,59858,5055,2,0,2,1,0.4
56641,46250,340,0,1,1,0,2.94
56644,53750,854,1,0,1,1,1.17
56646,42422,320,0,1,1,0,3.13
56649,70348,8923,4,9,13,0.308,1.46
56650,78750,771,0,4,4,0,5.19
56652,73594,509,0,1,1,0,1.96
56655,55368,1502,1,5,6,0.167,3.99
56657,70750,324,1,1,2,0.5,6.17
56660,62321,291,0,2,2,0,6.87
56662,64881,504,0,2,2,0,3.97
56666,50250,886,1,0,1,1,1.13
56667,79844,694,1,2,3,0.333,4.32
56672,60347,1972,1,2,3,0.333,1.52
56676,67679,1773,1,2,3,0.333,1.69
56683,86250,716,0,1,1,0,1.4
56686,70781,859,0,1,1,0,1.16
56701,73243,12798,5,20,25,0.2,1.95
56710,70000,511,1,1,2,0.5,3.91
56713,90833,904,1,1,2,0.5,2.21
56714,67708,1191,0,1,1,0,0.84
56715,72813,363,0,1,1,0,2.75
56716,56781,8965,1,14,15,0.067,1.67
56721,83633,10602,5,17,22,0.227,2.08
56722,88438,314,0,1,1,0,3.18
56723,108333,980,1,2,3,0.333,3.06
56726,70625,1471,0,2,2,0,1.36
56728,70750,1231,0,7,7,0,5.69
56732,67841,1097,0,1,1,0,0.91
56733,69250,371,0,1,1,0,2.7
56734,73393,374,0,2,2,0,5.35
56735,66625,831,0,2,2,0,2.41
56736,81500,859,0,2,2,0,2.33
56737,70536,809,1,0,1,1,1.24
56744,77222,526,1,1,2,0.5,3.8
56750,74688,2392,0,3,3,0,1.25
56751,77336,5648,5,9,14,0.357,2.48
56756,96563,769,0,1,1,0,1.3
56757,79219,853,0,1,1,0,1.17
56760,98750,406,0,1,1,0,2.46
56762,61719,2561,0,3,3,0,1.17
56763,70357,5132,0,8,8,0,1.56
